S S S S S S S W W W T T T T T T T T T T T T M W W W S S S S S S W W T T T T T T T T
S S S S S S S S W W M T T T T T T T T T T T M W W W S S S S S S W W W T M M T T T T
S S S S S S S S W W M T T M T T T M M M T T M W W W S S S S S S W W W T H M T T T T
S S S S S S S S W M T T T M M M M M M M T M W W W S S S S S S W W W T M H M M M M M
S S S S S S S S S W W H H M M M M M M H H W W S S S S S S S S S S S S M H H H H H H
S S S S S S S S S S S S S S S S S S S S S S S S S S S S S S S S S S S S S S S S S S
S S S S S S S S S S S S S S S S S S S S S S S S S S S S S S S S S S S S S S S S S S
G G G G G G G G G G G G G G G G G G G G G G G G G G G G G G G G G G G W W W W H M M
G G G G G G G G G G G G G G G G G G G G G G G G G G G G G G G G G G G W W W W H M M
G G G G G G G G G G G G G G G G G G G G G G G G G G G G G G G G G G G W W W W H H M
G G G G W W W W W G G G G G G G G G G G G W W W W G G G G G G G G G G G W W W H H H
G G G W W W W W W G G G G G G G G G G G W W W W W W G G G G G G G G G G G G W W H H
G G G G W W W W W W G G G G G G G G G G W W W W W W G G G G G G G G G G G G G G W H
G G G G W W W W W W G G G G G G G G G G G G G G G G G G G G G G G G G G G G G G G H
G G G G G G G G G G G G G G G G G G G G G G G G G G G G G G G G G G G G G G G W W W
G G G G G G G G G G G G G G G G G G G G G G G G G G G G G G G G G G G G G G W W W W
G G G G G G G G G G G G G G G G G G G G G G G G G G G G G G G G G G G G G G G G G G
G G G G G G G G G G G G G G G G G G G G G G G G G G G G G G G G G G G G G G G G G G
G G G G G G G G G G G G G G G G G G G G G G G G G G G G G G G G G G G G G G G G G G
G G G G G G G G G G G G G G G G G G G G G G G G G G G G G G G W W W W G G G G G G G
W W W W W G G G G G G G G G G G G G G G G G G G G G G G G G G W W W W G G G G G G G
W W W W W G G G G G G G G G G G G G G G G G G G G G G G G G G W W W W G G G G G G G
G G G G G G G G G G G G G G G G G G G G G G G G G G G G G G G W W W W G G G G G G G
G G G G G G G G G G G G G G G G G G G G G G G G G G G G G G G G G G G G G G G G G G
D D D D D D D D D D D D G G G G G G G G G G G G G G G G G G G G G G G G G G G G G G
D D D D D D D D D D D D D G G G G G G G G G G G G G G G G G G G G G G G G G G G G G
D D D D D D D D D D D D D G G G G G G G G G G G G G G G G G G G G G G G G G G G G G
D D D D D D D D D D D D G G G G G G G G G G G G G G G G G G G G G G G G G G G G G G